..................................................................]
..................................................................]
..................................................................]
<.................................................................]
<.................................................................]
<............................+....................................]
<.......+................>######<.................................]
<.@..+.>####<....+....>###//////###<...+.>#<..............>#...+.#]
########////###########////////////#######/######<..+..>###/#####/]
/////////////////////////////////////////////////#######//////////]