...*....................................*............*............]
...............................*.............>#<..................]
..........*.............>#####<.>####<.......*-........*..........]
<.....*..........*.......-----.*.----.......>##<...................]
<..................>#####<..........>#######<--...................]
<..*........>####<..-----............-------....>####<.............]
<........]...----........>######<................----.............]
<.@....>####<....+....>###//////###<...+.>#<..............>#######]
########////###########////////////#######/######<..+..>###///////]
/////////////////////////////////////////////////#######//////////]