...*....................................*............*........
...............................*.............#................
..........*.............#####.####.......*.........*..........
......*..........*.............*..........###.................
...................#####..........#######.....................
...*.........####.............................####............
.........................######...............................
..@....#####..........###//////###.....#####..............####
#######/////##########////////////#####/////######......##////
//////////////////////////////////////////////////######//////