..................................................................]]]
..................................................................]]]
..................................................................]]]
<.................................................................]]]
<.................................................................]]]
<............................+....................................]]]
<.......+................>######<.................................]]]
<.@..+.>####<....+....>###//////###<...+.>#<..............>#...+.####
########////###########////////////#######/######<..+..>###/#####/]]]
/////////////////////////////////////////////////#######//////////]]]