...*....................................*............*........]
...............................*.............#................]
..........*.............#####.####.......*.........*..........]
......*..........*.............*..........###.................]
...................#####..........#######.....................]
...*.........####.............................####............]
.........]...............######...........+...................]
..@....#####....+.....###//////###.....#####..............####]
#######/////##########////////////#####/////######..+...##////]
/////////////////////////////////////////////////######///////]