...*....................................*............*........
...............................*.............#................
..........*.............#####.####.......*.........*..........
......*..........*.............*..........###.................
...................#####..........#######.....................
...*.........####.............................####............
.........................######...........+...................
..@....#####....+.....###//////###.....#####..............####
#######/////##########////////////#####/////######..+...##////
//////////////////////////////////////////////////######//////